Date,Total,Died,Estimated Active,Daily Cases,Prior Daily Cases,Change Daily Cases,Prior Total Deaths,Current Deaths,Prior Active,Change Active,Prior Deaths,Change Deaths,Daily Cases Label,Change Daily Cases Label,Estimated Active Label,Change Active Label,Current Deaths Label,Change Deaths Label
2020-03-05,0,0,0,0,0,0,0,0,0,0,0,0,L,L+,L,L+,L,L+
2020-03-06,1,0,1,0,0,0,0,0,0,1,0,0,L,L+,L,L+,L,L+
2020-03-07,1,0,1,0,0,0,0,0,1,0,0,0,L,L+,L,L+,L,L+
2020-03-08,1,0,1,0,0,0,0,0,1,0,0,0,L,L+,L,L+,L,L+
2020-03-09,2,0,2,0,0,0,0,0,1,1,0,0,L,L+,L,L+,L,L+
2020-03-10,2,0,2,0,0,0,0,0,2,0,0,0,L,L+,L,L+,L,L+
2020-03-11,3,0,3,0,0,0,0,0,2,1,0,0,L,L+,L,L+,L,L+
2020-03-12,4,0,4,0,0,0,0,0,3,1,0,0,L,L+,L,L+,L,L+
2020-03-13,9,0,9,0,0,0,0,0,4,5,0,0,L,L+,L,L+,L,L+
2020-03-14,14,0,14,0,0,0,0,0,9,5,0,0,L,L+,L,L+,L,L+
2020-03-15,26,0,26,0,0,0,0,0,14,12,0,0,L,L+,L,L+,L,L+
2020-03-16,38,0,38,0,0,0,0,0,26,12,0,0,L,L+,L,L+,L,L+
2020-03-17,52,0,52,0,0,0,0,0,38,14,0,0,L,L+,L,L+,L,L+
2020-03-18,61,0,61,9,0,9,0,0,52,9,0,0,L,L+,L,L+,L,L+
2020-03-19,95,0,95,34,9,25,0,0,61,34,0,0,L,L+,L,L+,L,L+
2020-03-20,121,0,121,26,34,-8,0,0,95,26,0,0,L,L-,L,L+,L,L+
2020-03-21,143,0,143,22,26,-4,0,0,121,22,0,0,L,L-,L,L+,L,L+
2020-03-22,225,1,224,82,22,60,0,1,143,81,0,1,L,L+,L,L+,L,L+
2020-03-23,256,1,255,31,82,-51,1,0,224,31,1,-1,L,L-,L,L+,L,L-
2020-03-24,324,1,323,68,31,37,1,0,255,68,0,0,L,L+,L,L+,L,L+
2020-03-25,364,1,363,40,68,-28,1,0,323,40,0,0,L,L-,L,L+,L,L+
2020-03-26,450,3,447,86,40,46,1,2,363,84,0,2,L,L+,L,L+,L,M+
2020-03-27,574,4,569,124,86,38,3,1,447,122,2,-1,L,L+,L,L+,L,L-
2020-03-28,689,5,683,115,124,-9,4,1,569,114,1,0,L,L-,L,L+,L,L+
2020-03-29,789,7,781,100,115,-15,5,2,683,98,1,1,L,L-,L,L+,L,L+
2020-03-30,902,7,893,113,100,13,7,0,781,112,2,-2,L,L+,L,L+,L,M-
2020-03-31,984,9,973,82,113,-31,7,2,893,80,0,2,L,L-,L,L+,L,M+
2020-04-01,1065,9,1053,81,82,-1,9,0,973,80,2,-2,L,L-,L,L+,L,M-
2020-04-02,1268,10,1254,203,81,122,9,1,1053,201,0,1,L,L+,L,L+,L,L+
2020-04-03,1425,10,1406,157,203,-46,10,0,1254,152,1,-1,L,L-,L,L+,L,L-
2020-04-04,1592,15,1563,167,157,10,10,5,1406,157,0,5,L,L+,L,L+,M,H+
2020-04-05,1665,15,1624,73,167,-94,15,0,1563,61,5,-5,L,L-,L,L+,L,H-
2020-04-06,1731,15,1678,66,73,-7,15,0,1624,54,0,0,L,L-,L,L+,L,L+
2020-04-07,1814,16,1747,83,66,17,15,1,1678,69,0,1,L,L+,L,L+,L,L+
2020-04-08,1964,17,1887,150,83,67,16,1,1747,140,1,0,L,L+,L,L+,L,L+
2020-04-09,2089,19,1977,125,150,-25,17,2,1887,90,1,1,L,L-,L,L+,L,L+
2020-04-10,2209,22,2068,120,125,-5,19,3,1977,91,2,1,L,L-,L,L+,M,L+
2020-04-11,2309,22,2148,100,120,-20,22,0,2068,80,3,-3,L,L-,L,L+,L,M-
2020-04-12,2368,22,2127,59,100,-41,22,0,2148,-21,0,0,L,L-,L,L-,L,L+
2020-04-13,2415,22,2143,47,59,-12,22,0,2127,16,0,0,L,L-,L,L+,L,L+
2020-04-14,2537,23,2197,122,47,75,22,1,2143,54,0,1,L,L+,L,L+,L,L+
2020-04-15,2674,24,2295,137,122,15,23,1,2197,98,1,0,L,L+,L,L+,L,L+
2020-04-16,2804,25,2339,130,137,-7,24,1,2295,44,1,0,L,L-,L,L+,L,L+
2020-04-17,2939,26,2351,135,130,5,25,1,2339,12,1,0,L,L+,L,L+,L,L+
2020-04-18,3071,29,2366,132,135,-3,26,3,2351,15,1,2,L,L-,L,L+,M,M+
2020-04-19,3219,30,2416,148,132,16,29,1,2366,50,3,-2,L,L+,L,L+,L,M-
2020-04-20,3308,35,2388,89,148,-59,30,5,2416,-28,1,4,L,L-,L,L-,M,H+
2020-04-21,3446,35,2445,138,89,49,35,0,2388,57,5,-5,L,L+,L,L+,L,H-
2020-04-22,3607,37,2524,161,138,23,35,2,2445,79,0,2,L,L+,L,L+,L,M+
2020-04-23,3763,43,2476,156,161,-5,37,6,2524,-48,2,4,L,L-,L,L-,H,H+
2020-04-24,3944,43,2504,181,156,25,43,0,2476,28,6,-6,L,L+,L,L+,L,H-
2020-04-25,4126,45,2518,182,181,1,43,2,2504,14,0,2,L,L+,L,L+,L,M+
2020-04-26,4236,46,2554,110,182,-72,45,1,2518,36,2,-1,L,L-,L,L+,L,L-
2020-04-27,4331,47,2583,95,110,-15,46,1,2554,29,1,0,L,L-,L,L+,L,L+
2020-04-28,4478,47,2647,147,95,52,47,0,2583,64,1,-1,L,L+,L,L+,L,L-
2020-04-29,4653,47,2674,175,147,28,47,0,2647,27,0,0,L,L+,L,L+,L,L+
2020-04-30,4809,50,2704,156,175,-19,47,3,2674,30,0,3,L,L-,L,L+,M,M+
2020-05-01,4966,53,2738,157,156,1,50,3,2704,34,3,0,L,L+,L,L+,M,L+
2020-05-02,5153,56,2825,187,157,30,53,3,2738,87,3,0,L,L+,L,L+,M,L+
2020-05-03,5286,57,2898,133,187,-54,56,1,2825,73,3,-2,L,L-,L,L+,L,M-
2020-05-04,5415,58,2982,129,133,-4,57,1,2898,84,1,0,L,L-,L,L+,L,L+
2020-05-05,5570,61,3013,155,129,26,58,3,2982,31,1,2,L,L+,L,L+,M,M+
2020-05-06,5698,64,3005,128,155,-27,61,3,3013,-8,3,0,L,L-,L,L-,M,L+
2020-05-07,5892,66,3071,194,128,66,64,2,3005,66,3,-1,L,L+,L,L+,L,L-
2020-05-08,6077,70,3123,185,194,-9,66,4,3071,52,2,2,L,L-,L,L+,M,M+
2020-05-09,6228,73,3140,151,185,-34,70,3,3123,17,4,-1,L,L-,L,L+,M,L-
2020-05-10,6344,75,3108,116,151,-35,73,2,3140,-32,3,-1,L,L-,L,L-,L,L-
2020-05-11,6417,78,3091,73,116,-43,75,3,3108,-17,2,1,L,L-,L,L-,M,L+
2020-05-12,6600,79,3138,183,73,110,78,1,3091,47,3,-2,L,L+,L,L+,L,M-
2020-05-13,6729,83,3106,129,183,-54,79,4,3138,-32,1,3,L,L-,L,L-,M,M+
2020-05-14,6893,86,3115,164,129,35,83,3,3106,9,4,-1,L,L+,L,L+,M,L-
2020-05-15,7046,90,3087,153,164,-11,86,4,3115,-28,3,1,L,L-,L,L-,M,L+
2020-05-16,7218,93,3077,172,153,19,90,3,3087,-10,4,-1,L,L+,L,L-,M,L-
2020-05-17,7366,95,3115,148,172,-24,93,2,3077,38,3,-1,L,L-,L,L+,L,L-
2020-05-18,7503,98,3156,137,148,-11,95,3,3115,41,2,1,L,L-,L,L+,M,L+
2020-05-19,7702,98,3209,199,137,62,98,0,3156,53,3,-3,L,L+,L,L+,L,M-
2020-05-20,7862,100,3195,160,199,-39,98,2,3209,-14,0,2,L,L-,L,L-,L,M+
2020-05-21,8056,103,3234,194,160,34,100,3,3195,39,2,1,L,L+,L,L+,M,L+
2020-05-22,8239,105,3263,183,194,-11,103,2,3234,29,3,-1,L,L-,L,L+,L,L-
2020-05-23,8379,107,3221,140,183,-43,105,2,3263,-42,2,0,L,L-,L,L-,L,L+
2020-05-24,8510,109,3219,131,140,-9,107,2,3221,-2,2,0,L,L-,L,L-,L,L+
2020-05-25,8605,111,3184,95,131,-36,109,2,3219,-35,2,0,L,L-,L,L-,L,L+
2020-05-26,8690,112,3115,85,95,-10,111,1,3184,-69,2,-1,L,L-,L,L-,L,L-
2020-05-27,8927,112,3225,237,85,152,112,0,3115,110,1,-1,L,L+,L,L+,L,L-
2020-05-28,9260,116,3364,333,237,96,112,4,3225,139,0,4,L,L+,L,L+,M,H+
2020-05-29,9537,116,3459,277,333,-56,116,0,3364,95,4,-4,L,L-,L,L+,L,H-
2020-05-30,9809,118,3584,272,277,-5,116,2,3459,125,0,2,L,L-,L,L+,L,M+
2020-05-31,10016,120,3673,207,272,-65,118,2,3584,89,2,0,L,L-,L,L+,L,L+
2020-06-01,10218,123,3806,202,207,-5,120,3,3673,133,2,1,L,L-,L,L+,M,L+
2020-06-02,10499,123,3905,281,202,79,123,0,3806,99,3,-3,L,L+,L,L+,L,M-
2020-06-03,10811,126,4087,312,281,31,123,3,3905,182,0,3,L,L+,L,L+,M,M+
2020-06-04,11259,128,4370,448,312,136,126,2,4087,283,3,-1,L,L+,L,L+,L,L-
2020-06-05,11805,128,4765,546,448,98,128,0,4370,395,2,-2,L,L+,L,L+,L,M-
2020-06-06,12083,131,4870,278,546,-268,128,3,4765,105,0,3,L,L-,L,L+,M,M+
2020-06-07,12366,134,5005,283,278,5,131,3,4870,135,3,0,L,L+,L,L+,M,L+
2020-06-08,12562,134,5066,196,283,-87,134,0,5005,61,3,-3,L,L-,L,L+,L,M-
2020-06-09,12874,139,5179,312,196,116,134,5,5066,113,0,5,L,L+,L,L+,M,H+
2020-06-10,13246,143,5389,372,312,60,139,4,5179,210,5,-1,L,L+,L,L+,M,L-
2020-06-11,13582,144,5532,336,372,-36,143,1,5389,143,4,-3,L,L-,L,L+,L,M-
2020-06-12,13984,149,5750,402,336,66,144,5,5532,218,1,4,L,L+,L,L+,M,H+
2020-06-13,14324,150,5952,340,402,-62,149,1,5750,202,5,-4,L,L-,L,L+,L,H-
2020-06-14,14627,152,6123,303,340,-37,150,2,5952,171,1,1,L,L-,L,L+,L,L+
2020-06-15,14945,153,6348,318,303,15,152,1,6123,225,2,-1,L,L+,L,L+,L,L-
2020-06-16,15367,154,6687,422,318,104,153,1,6348,339,1,0,L,L+,L,L+,L,L+
2020-06-17,15854,159,6939,487,422,65,154,5,6687,252,1,4,L,L+,L,L+,M,H+
2020-06-18,16458,162,7210,604,487,117,159,3,6939,271,5,-2,L,L+,L,L+,M,M-
2020-06-19,17106,164,7580,648,604,44,162,2,7210,370,3,-1,L,L+,L,L+,L,L-
2020-06-20,17519,166,7719,413,648,-235,164,2,7580,139,2,0,L,L-,L,L+,L,L+
2020-06-21,17972,168,7967,453,413,40,166,2,7719,248,2,0,L,L+,L,L+,L,L+
2020-06-22,18338,171,8131,366,453,-87,168,3,7967,164,2,1,L,L-,L,L+,M,L+
2020-06-23,18828,172,8346,490,366,124,171,1,8131,215,3,-2,L,L+,L,L+,L,M-
2020-06-24,19431,176,8635,603,490,113,172,4,8346,289,1,3,L,L+,L,L+,M,M+
2020-06-25,20084,177,8841,653,603,50,176,1,8635,206,4,-3,L,L+,L,L+,L,M-
2020-06-26,20653,178,8865,569,653,-84,177,1,8841,24,1,0,L,L-,L,L+,L,L+
2020-06-27,21150,181,9082,497,569,-72,178,3,8865,217,1,2,L,L-,L,L+,M,M+
2020-06-28,21748,183,9397,598,497,101,181,2,9082,315,3,-1,L,L+,L,L+,L,L-
2020-06-29,22283,186,9735,535,598,-63,183,3,9397,338,2,1,L,L-,L,L+,M,L+
2020-06-30,22798,190,9934,515,535,-20,186,4,9735,199,3,1,L,L-,L,L+,M,L+
2020-07-01,23366,193,10128,568,515,53,190,3,9934,194,4,-1,L,L+,L,L+,M,L-
2020-07-02,23990,195,10415,624,568,56,193,2,10128,287,3,-1,L,L+,L,L+,L,L-
2020-07-03,24669,198,10691,679,624,55,195,3,10415,276,2,1,L,L+,L,L+,M,L+
2020-07-04,25080,202,10761,411,679,-268,198,4,10691,70,3,1,L,L-,L,L+,M,L+
2020-07-05,25615,208,10990,535,411,124,202,6,10761,229,4,2,L,L+,L,L+,H,M+
2020-07-06,26201,212,11257,586,535,51,208,4,10990,267,6,-2,L,L+,L,L+,M,M-
2020-07-07,26952,219,11581,751,586,165,212,7,11257,324,4,3,L,L+,L,L+,H,M+
2020-07-08,27579,226,11718,627,751,-124,219,7,11581,137,7,0,L,L-,L,L+,H,L+
2020-07-09,28455,230,11988,876,627,249,226,4,11718,270,7,-3,L,L+,L,L+,M,M-
2020-07-10,29080,232,11974,625,876,-251,230,2,11988,-14,4,-2,L,L-,L,L-,L,M-
2020-07-11,29724,238,12205,644,625,19,232,6,11974,231,2,4,L,L+,L,L+,H,H+
2020-07-12,30315,240,12344,591,644,-53,238,2,12205,139,6,-4,L,L-,L,L+,L,H-
2020-07-13,30793,244,12455,478,591,-113,240,4,12344,111,2,2,L,L-,L,L+,M,M+
2020-07-14,31254,247,12430,461,478,-17,244,3,12455,-25,4,-1,L,L-,L,L-,M,L-
2020-07-15,31963,252,12537,709,461,248,247,5,12430,107,3,2,L,L+,L,L+,M,M+
2020-07-16,32710,257,12630,747,709,38,252,5,12537,93,5,0,L,L+,L,L+,M,L+
2020-07-17,33452,262,12801,742,747,-5,257,5,12630,171,5,0,L,L-,L,L+,M,L+
2020-07-18,34255,266,13106,803,742,61,262,4,12801,305,5,-1,L,L+,L,L+,M,L-
2020-07-19,34667,272,12919,412,803,-391,266,6,13106,-187,4,2,L,M-,L,L-,H,M+
2020-07-20,35114,279,12830,447,412,35,272,7,12919,-89,6,1,L,L+,L,L-,H,L+
2020-07-21,35670,285,12871,556,447,109,279,6,12830,41,7,-1,L,L+,L,L+,H,L-
2020-07-22,36181,291,12817,511,556,-45,285,6,12871,-54,6,0,L,L-,L,L-,H,L+
2020-07-23,37051,300,13055,870,511,359,291,9,12817,238,6,3,L,M+,L,L+,H,M+
2020-07-24,37719,303,13048,668,870,-202,300,3,13055,-7,9,-6,L,L-,L,L-,M,H-
2020-07-25,38077,307,12997,358,668,-310,303,4,13048,-51,3,1,L,M-,L,L-,M,L+
2020-07-26,38512,312,12900,435,358,77,307,5,12997,-97,4,1,L,L+,L,L-,M,L+
2020-07-27,38935,314,12742,423,435,-12,312,2,12900,-158,5,-3,L,L-,L,L-,L,M-
2020-07-28,39275,318,12344,340,423,-83,314,4,12742,-398,2,2,L,L-,L,L-,M,M+
2020-07-29,39771,324,12218,496,340,156,318,6,12344,-126,4,2,L,L+,L,L-,H,M+
2020-07-30,40278,327,11854,507,496,11,324,3,12218,-364,6,-3,L,L+,L,L-,M,M-
2020-07-31,40770,329,11727,492,507,-15,327,2,11854,-127,3,-1,L,L-,L,L-,L,L-
2020-08-01,41251,332,11569,481,492,-11,329,3,11727,-158,2,1,L,L-,L,L-,M,L+
2020-08-02,41592,338,11331,341,481,-140,332,6,11569,-238,3,3,L,L-,L,L-,H,M+
2020-08-03,41962,341,11229,370,341,29,338,3,11331,-102,6,-3,L,L+,L,L-,M,M-
2020-08-04,42374,344,11180,412,370,42,341,3,11229,-49,3,0,L,L+,L,L-,M,L+
2020-08-05,42952,347,11051,578,412,166,344,3,11180,-129,3,0,L,L+,L,L-,M,L+
2020-08-06,43405,352,10753,453,578,-125,347,5,11051,-298,3,2,L,L-,L,L-,M,M+
2020-08-07,43789,358,10389,384,453,-69,352,6,10753,-364,5,1,L,L-,L,L-,H,L+
2020-08-08,44170,361,9971,381,384,-3,358,3,10389,-418,6,-3,L,L-,L,L-,M,M-
2020-08-09,44442,366,9831,272,381,-109,361,5,9971,-140,3,2,L,L-,L,L-,M,M+
2020-08-10,44794,369,9735,352,272,80,366,3,9831,-96,5,-2,L,L+,L,L-,M,M-
2020-08-11,45115,370,9507,321,352,-31,369,1,9735,-228,3,-2,L,L-,L,L-,L,M-
2020-08-12,45449,377,9332,334,321,13,370,7,9507,-175,1,6,L,L+,L,L-,H,H+
2020-08-13,46007,378,9023,558,334,224,377,1,9332,-309,7,-6,L,L+,L,L-,L,H-
2020-08-14,46364,382,8711,357,558,-201,378,4,9023,-312,1,3,L,L-,L,L-,M,M+
2020-08-15,46703,389,8687,339,357,-18,382,7,8711,-24,4,3,L,L-,L,L-,H,M+
2020-08-16,46942,391,8491,239,339,-100,389,2,8687,-196,7,-5,L,L-,L,L-,L,H-
2020-08-17,47204,392,8330,262,239,23,391,1,8491,-161,2,-1,L,L+,L,L-,L,L-
2020-08-18,47568,394,8358,364,262,102,392,2,8330,28,1,1,L,L+,L,L+,L,L+
2020-08-19,48026,396,8323,458,364,94,394,2,8358,-35,2,0,L,L+,L,L-,L,L+
2020-08-20,48509,398,8300,483,458,25,396,2,8323,-23,2,0,L,L+,L,L-,L,L+
2020-08-21,48884,405,8181,375,483,-108,398,7,8300,-119,2,5,L,L-,L,L-,H,H+
2020-08-22,49182,407,7998,298,375,-77,405,2,8181,-183,7,-5,L,L-,L,L-,L,H-
2020-08-23,49431,410,7909,249,298,-49,407,3,7998,-89,2,1,L,L-,L,L-,M,L+
2020-08-24,49833,412,7941,402,249,153,410,2,7909,32,3,-1,L,L+,L,L+,L,L-
2020-08-25,50246,414,7946,413,402,11,412,2,7941,5,2,0,L,L+,L,L+,L,L+
2020-08-26,50633,414,7761,387,413,-26,414,0,7946,-185,2,-2,L,L-,L,L-,L,M-
2020-08-27,51024,416,7700,391,387,4,414,2,7761,-61,0,2,L,L+,L,L-,L,M+
2020-08-28,51497,416,7791,473,391,82,416,0,7700,91,2,-2,L,L+,L,L+,L,M-
2020-08-29,51960,417,7873,463,473,-10,416,1,7791,82,0,1,L,L-,L,L+,L,L+
2020-08-30,52216,418,7858,256,463,-207,417,1,7873,-15,1,0,L,L-,L,L-,L,L+
2020-08-31,52505,419,7798,289,256,33,418,1,7858,-60,1,0,L,L+,L,L-,L,L+
2020-09-01,52927,423,7896,422,289,133,419,4,7798,98,1,3,L,L+,L,L+,M,M+
2020-09-02,53441,425,8074,514,422,92,423,2,7896,178,4,-2,L,L+,L,L+,L,M-
2020-09-03,53948,430,8018,507,514,-7,425,5,8074,-56,2,3,L,L-,L,L-,M,M+
2020-09-04,54401,435,8112,453,507,-54,430,5,8018,94,5,0,L,L-,L,L+,M,L+
2020-09-05,54804,436,8177,403,453,-50,435,1,8112,65,5,-4,L,L-,L,L+,L,H-
2020-09-06,55145,440,8279,341,403,-62,436,4,8177,102,1,3,L,L-,L,L+,M,M+
2020-09-07,55461,441,8335,316,341,-25,440,1,8279,56,4,-3,L,L-,L,L+,L,M-
2020-09-08,55774,443,8286,313,316,-3,441,2,8335,-49,1,1,L,L-,L,L-,L,L+
2020-09-09,56162,443,8217,388,313,75,443,0,8286,-69,2,-2,L,L+,L,L-,L,M-
2020-09-10,56842,445,8413,680,388,292,443,2,8217,196,0,2,L,M+,L,L+,L,M+
2020-09-11,57431,446,8627,589,680,-91,445,1,8413,214,2,-1,L,L-,L,L+,L,L-
2020-09-12,58087,448,8985,656,589,67,446,2,8627,358,1,1,L,L+,L,L+,L,L+
2020-09-13,58644,449,9292,557,656,-99,448,1,8985,307,2,-1,L,L-,L,L+,L,L-
2020-09-14,59224,450,9471,580,557,23,449,1,9292,179,1,0,L,L+,L,L+,L,L+
2020-09-15,59971,450,9811,747,580,167,450,0,9471,340,1,-1,L,L+,L,L+,L,L-
2020-09-16,60889,451,10344,918,747,171,450,1,9811,533,0,1,M,L+,L,L+,L,L+
2020-09-17,62012,452,11080,1123,918,205,451,1,10344,736,1,0,M,L+,L,L+,L,L+
2020-09-18,63104,454,11698,1092,1123,-31,452,2,11080,618,1,1,M,L-,L,L+,L,L+
2020-09-19,64023,455,12154,919,1092,-173,454,1,11698,456,2,-1,M,L-,L,L+,L,L-
2020-09-20,64664,456,12540,641,919,-278,455,1,12154,386,1,0,L,L-,L,L+,L,L+
2020-09-21,65300,458,12887,636,641,-5,456,2,12540,347,1,1,L,L-,L,L+,L,L+
2020-09-22,66195,459,13363,895,636,259,458,1,12887,476,2,-1,M,L+,L,L+,L,L-
2020-09-23,67431,463,14083,1236,895,341,459,4,13363,720,1,3,M,M+,L,L+,M,M+
2020-09-24,68865,467,15008,1434,1236,198,463,4,14083,925,4,0,M,L+,L,L+,M,L+
2020-09-25,69896,472,15583,1031,1434,-403,467,5,15008,575,4,1,M,M-,L,L+,M,L+
2020-09-26,70974,477,16255,1078,1031,47,472,5,15583,672,5,0,M,L+,L,L+,M,L+
2020-09-27,71860,478,16801,886,1078,-192,477,1,16255,546,5,-4,M,L-,M,L+,L,H-
2020-09-28,72524,481,17147,664,886,-222,478,3,16801,346,1,2,L,L-,M,L+,M,M+
2020-09-29,73449,483,17758,925,664,261,481,2,17147,611,3,-1,M,L+,M,L+,L,L-
2020-09-30,74452,489,18370,1003,925,78,483,6,17758,612,2,4,M,L+,M,L+,H,H+
2020-10-01,75583,494,18822,1131,1003,128,489,5,18370,452,6,-1,M,L+,M,L+,M,L-
2020-10-02,76685,495,19336,1102,1131,-29,494,1,18822,514,5,-4,M,L-,M,L+,L,H-
2020-10-03,78076,503,20067,1391,1102,289,495,8,19336,731,1,7,M,M+,M,L+,H,H+
2020-10-04,79161,508,20593,1085,1391,-306,503,5,20067,526,8,-3,M,M-,M,L+,M,M-
2020-10-05,79900,511,20752,739,1085,-346,508,3,20593,159,5,-2,L,M-,M,L+,M,M-
2020-10-06,80895,521,20995,995,739,256,511,10,20752,243,3,7,M,L+,M,L+,H,H+
2020-10-07,82406,529,21584,1511,995,516,521,8,20995,589,10,-2,M,M+,M,L+,H,M-
2020-10-08,83774,535,21826,1368,1511,-143,529,6,21584,242,8,-2,M,L-,M,L+,H,M-
2020-10-09,85147,540,22106,1373,1368,5,535,5,21826,280,6,-1,M,L+,M,L+,M,L-
2020-10-10,86365,544,22406,1218,1373,-155,540,4,22106,300,5,-1,M,L-,M,L+,M,L-
2020-10-11,87359,551,22755,994,1218,-224,544,7,22406,349,4,3,M,L-,M,L+,H,M+
2020-10-12,88319,553,23079,960,994,-34,551,2,22755,324,7,-5,M,L-,M,L+,L,H-
2020-10-13,89468,556,23336,1149,960,189,553,3,23079,257,2,1,M,L+,M,L+,M,L+
2020-10-14,90985,561,23621,1517,1149,368,556,5,23336,285,3,2,M,M+,M,L+,M,M+
2020-10-15,92509,567,23718,1524,1517,7,561,6,23621,97,5,1,M,L+,M,L+,H,L+
2020-10-16,93842,571,24024,1333,1524,-191,567,4,23718,306,6,-2,M,L-,M,L+,M,M-
2020-10-17,94967,576,24075,1125,1333,-208,571,5,24024,51,4,1,M,L-,M,L+,M,L+
2020-10-18,96147,581,24367,1180,1125,55,576,5,24075,292,5,0,M,L+,M,L+,M,L+
2020-10-19,97204,582,24763,1057,1180,-123,581,1,24367,396,5,-4,M,L-,M,L+,L,H-
2020-10-20,98502,586,25138,1298,1057,241,582,4,24763,375,1,3,M,L+,M,L+,M,M+
2020-10-21,100154,597,25793,1652,1298,354,586,11,25138,655,4,7,M,M+,M,L+,E,H+
2020-10-22,102174,599,26687,2020,1652,368,597,2,25793,894,11,-9,H,M+,M,L+,L,H-
2020-10-23,103808,603,27219,1634,2020,-386,599,4,26687,532,2,2,M,M-,M,L+,M,M+
2020-10-24,105635,611,27653,1827,1634,193,603,8,27219,434,4,4,H,L+,M,L+,H,H+
2020-10-25,106811,618,27743,1176,1827,-651,611,7,27653,90,8,-1,M,H-,M,L+,H,L-
2020-10-26,107945,624,28134,1134,1176,-42,618,6,27743,391,7,-1,M,L-,M,L+,H,L-
2020-10-27,109535,633,28729,1590,1134,456,624,9,28134,595,6,3,M,M+,M,L+,H,M+
2020-10-28,111395,641,29075,1860,1590,270,633,8,28729,346,9,-1,H,L+,M,L+,H,L-
2020-10-29,113788,646,30104,2393,1860,533,641,5,29075,1029,8,-3,H,M+,M,M+,M,M-
2020-10-30,115515,661,30449,1727,2393,-666,646,15,30104,345,5,10,M,H-,M,L+,E,H+
2020-10-31,117389,664,31112,1874,1727,147,661,3,30449,663,15,-12,H,L+,M,L+,M,H-
2020-11-01,118598,672,31327,1209,1874,-665,664,8,31112,215,3,5,M,H-,M,L+,H,H+
2020-11-02,120284,680,32047,1686,1209,477,672,8,31327,720,8,0,M,M+,M,L+,H,L+
2020-11-03,122419,699,33021,2135,1686,449,680,19,32047,974,8,11,H,M+,M,L+,E,H+
2020-11-04,125263,703,34358,2844,2135,709,699,4,33021,1337,19,-15,H,H+,H,M+,M,H-
2020-11-05,128310,719,35875,3047,2844,203,703,16,34358,1517,4,12,H,L+,H,M+,E,H+
2020-11-06,131317,731,37542,3007,3047,-40,719,12,35875,1667,16,-4,H,L-,H,M+,E,H-
2020-11-07,133771,735,38872,2454,3007,-553,731,4,37542,1330,12,-8,H,M-,H,M+,M,H-
2020-11-08,136019,747,39940,2248,2454,-206,735,12,38872,1068,4,8,H,L-,H,M+,E,H+
2020-11-09,138458,753,41324,2439,2248,191,747,6,39940,1384,12,-6,H,L+,H,M+,H,H-
2020-11-10,140776,761,42347,2318,2439,-121,753,8,41324,1023,6,2,H,L-,H,M+,H,M+
2020-11-11,144777,776,44694,4001,2318,1683,761,15,42347,2347,8,7,E,H+,H,H+,E,H+
2020-11-12,148219,784,46120,3442,4001,-559,776,8,44694,1426,15,-7,H,H-,H,M+,H,H-
2020-11-13,152339,797,48601,4120,3442,678,784,13,46120,2481,8,5,E,H+,H,H+,E,H+
2020-11-14,155003,811,49430,2664,4120,-1456,797,14,48601,829,13,1,H,H-,H,L+,E,L+
2020-11-15,156992,825,50235,1989,2664,-675,811,14,49430,805,14,0,H,H-,H,L+,E,L+
2020-11-16,160180,836,52288,3188,1989,1199,825,11,50235,2053,14,-3,H,H+,H,H+,E,M-
2020-11-17,163184,852,53704,3004,3188,-184,836,16,52288,1416,11,5,H,L-,H,M+,E,H+
2020-11-18,167190,870,55846,4006,3004,1002,852,18,53704,2142,16,2,E,H+,H,H+,E,M+
2020-11-19,171833,890,58091,4643,4006,637,870,20,55846,2245,18,2,E,H+,H,H+,E,M+
2020-11-20,175235,909,59759,3402,4643,-1241,890,19,58091,1668,20,-1,H,H-,H,M+,E,L-
2020-11-21,178518,921,61169,3283,3402,-119,909,12,59759,1410,19,-7,H,L-,H,M+,E,H-
2020-11-22,180741,936,62174,2223,3283,-1060,921,15,61169,1005,12,3,H,H-,H,M+,E,M+
2020-11-23,183412,957,63150,2671,2223,448,936,21,62174,976,15,6,H,M+,H,L+,E,H+
2020-11-24,185196,983,62787,1784,2671,-887,957,26,63150,-363,21,5,H,H-,H,L-,E,H+
2020-11-25,189085,995,63840,3889,1784,2105,983,12,62787,1053,26,-14,E,H+,H,M+,E,H-
2020-11-26,191390,1012,63111,2305,3889,-1584,995,17,63840,-729,12,5,H,H-,H,L-,E,H+
2020-11-27,193467,1021,62193,2077,2305,-228,1012,9,63111,-918,17,-8,H,L-,H,L-,H,H-
2020-11-28,195211,1034,61484,1744,2077,-333,1021,13,62193,-709,9,4,M,M-,H,L-,E,H+
2020-11-29,197131,1055,61147,1920,1744,176,1034,21,61484,-337,13,8,H,L+,H,L-,E,H+
2020-11-30,199665,1072,61244,2534,1920,614,1055,17,61147,97,21,-4,H,H+,H,L+,E,H-
2020-12-01,203713,1094,62970,4048,2534,1514,1072,22,61244,1726,17,5,E,H+,H,M+,E,H+
2020-12-02,207657,1109,62916,3944,4048,-104,1094,15,62970,-54,22,-7,E,L-,H,L-,E,H-
2020-12-03,210655,1119,62485,2998,3944,-946,1109,10,62916,-431,15,-5,H,H-,H,L-,H,H-
2020-12-04,214363,1137,62082,3708,2998,710,1119,18,62485,-403,10,8,E,H+,H,L-,E,H+
2020-12-05,216963,1158,62016,2600,3708,-1108,1137,21,62082,-66,18,3,H,H-,H,L-,E,M+
2020-12-06,219174,1175,62238,2211,2600,-389,1158,17,62016,222,21,-4,H,M-,H,L+,E,H-
2020-12-07,221502,1198,61382,2328,2211,117,1175,23,62238,-856,17,6,H,L+,H,L-,E,H+
2020-12-08,224076,1213,60962,2574,2328,246,1198,15,61382,-420,23,-8,H,L+,H,L-,E,H-
2020-12-09,227504,1232,60373,3428,2574,854,1213,19,60962,-589,15,4,H,H+,H,L-,E,H+
2020-12-10,230706,1253,58950,3202,3428,-226,1232,21,60373,-1423,19,2,H,L-,H,M-,E,M+
2020-12-11,233417,1271,58273,2711,3202,-491,1253,18,58950,-677,21,-3,H,M-,H,L-,E,M-
2020-12-12,235513,1288,57084,2096,2711,-615,1271,17,58273,-1189,18,-1,H,H-,H,M-,E,L-
2020-12-13,237476,1307,56821,1963,2096,-133,1288,19,57084,-263,17,2,H,L-,H,L-,E,M+
2020-12-14,239410,1323,56095,1934,1963,-29,1307,16,56821,-726,19,-3,H,L-,H,L-,E,M-
2020-12-15,242447,1336,57357,3037,1934,1103,1323,13,56095,1262,16,-3,H,H+,H,M+,E,M-
2020-12-16,245659,1358,56679,3212,3037,175,1336,22,57357,-678,13,9,H,L+,H,L-,E,H+
2020-12-17,248343,1378,57051,2684,3212,-528,1358,20,56679,372,22,-2,H,M-,H,L+,E,M-
2020-12-18,250774,1392,57417,2431,2684,-253,1378,14,57051,366,20,-6,H,L-,H,L+,E,H-
2020-12-19,252788,1410,57687,2014,2431,-417,1392,18,57417,270,14,4,H,M-,H,L+,E,H+
2020-12-20,254591,1424,57568,1803,2014,-211,1410,14,57687,-119,18,-4,H,L-,H,L-,E,H-
2020-12-21,256876,1439,57335,2285,1803,482,1424,15,57568,-233,14,1,H,M+,H,L-,E,L+
2020-12-22,259530,1452,55957,2654,2285,369,1439,13,57335,-1378,15,-2,H,M+,H,M-,E,M-
2020-12-23,262455,1466,54942,2925,2654,271,1452,14,55957,-1015,13,1,H,L+,H,M-,E,L+
2020-12-24,265002,1478,54488,2547,2925,-378,1466,12,54942,-454,14,-2,H,M-,H,L-,E,M-
2020-12-25,265993,1489,51786,991,2547,-1556,1478,11,54488,-2702,12,-1,M,H-,H,H-,E,L-
2020-12-26,266808,1505,49993,815,991,-176,1489,16,51786,-1793,11,5,L,L-,H,M-,E,H+
2020-12-27,268519,1519,49491,1711,815,896,1505,14,49993,-502,16,-2,M,H+,H,L-,E,M-
2020-12-28,271271,1536,49915,2752,1711,1041,1519,17,49491,424,14,3,H,H+,H,L+,E,M+
2020-12-29,273902,1548,49978,2631,2752,-121,1536,12,49915,63,17,-5,H,L-,H,L+,E,H-
2020-12-30,278608,1557,51273,4706,2631,2075,1548,9,49978,1295,12,-3,E,H+,H,M+,H,M-
2020-12-31,281731,1571,51193,3123,4706,-1583,1557,14,51273,-80,9,5,H,H-,H,L-,E,H+
2021-01-01,283687,1586,50438,1956,3123,-1167,1571,15,51193,-755,14,1,H,H-,H,L-,E,L+
2021-01-02,285533,1598,50192,1846,1956,-110,1586,12,50438,-246,15,-3,H,L-,H,L-,E,M-
2021-01-03,287706,1608,50406,2173,1846,327,1598,10,50192,214,12,-2,H,M+,H,L+,H,M-
2021-01-04,291096,1620,51864,3390,2173,1217,1608,12,50406,1458,10,2,H,H+,H,M+,E,M+
2021-01-05,294916,1643,52653,3820,3390,430,1620,23,51864,789,12,11,E,M+,H,L+,E,H+
2021-01-06,299540,1660,54068,4624,3820,804,1643,17,52653,1415,23,-6,E,H+,H,M+,E,H-
2021-01-07,303382,1672,55238,3842,4624,-782,1660,12,54068,1170,17,-5,E,H-,H,M+,E,H-
2021-01-08,306012,1688,55436,2630,3842,-1212,1672,16,55238,198,12,4,H,H-,H,L+,E,H+
2021-01-09,308337,1706,55740,2325,2630,-305,1688,18,55436,304,16,2,H,M-,H,L+,E,M+
2021-01-10,309811,1722,55410,1474,2325,-851,1706,16,55740,-330,18,-2,M,H-,H,L-,E,M-
2021-01-11,311960,1734,55279,2149,1474,675,1722,12,55410,-131,16,-4,H,H+,H,L-,E,H-
2021-01-12,314878,1744,55558,2918,2149,769,1734,10,55279,279,12,-2,H,H+,H,L+,H,M-
2021-01-13,317635,1758,55400,2757,2918,-161,1744,14,55558,-158,10,4,H,L-,H,L-,E,H+
2021-01-14,320059,1771,55283,2424,2757,-333,1758,13,55400,-117,14,-1,H,M-,H,L-,E,L-
2021-01-15,322218,1791,56434,2159,2424,-265,1771,20,55283,1151,13,7,H,L-,H,M+,E,H+
2021-01-16,323799,1806,57194,1581,2159,-578,1791,15,56434,760,20,-5,M,H-,H,L+,E,H-
2021-01-17,324872,1821,56549,1073,1581,-508,1806,15,57194,-645,15,0,M,M-,H,L-,E,L+
2021-01-18,326180,1834,55108,1308,1073,235,1821,13,56549,-1441,15,-2,M,L+,H,M-,E,M-
2021-01-19,328332,1849,54625,2152,1308,844,1834,15,55108,-483,13,2,H,H+,H,L-,E,M+
2021-01-20,330426,1862,52020,2094,2152,-58,1849,13,54625,-2605,15,-2,H,L-,H,H-,E,M-
2021-01-21,333066,1877,51533,2640,2094,546,1862,15,52020,-487,13,2,H,M+,H,L-,E,M+
2021-01-22,334830,1891,51338,1764,2640,-876,1877,14,51533,-195,15,-1,M,H-,H,L-,E,L-
2021-01-23,336337,1907,50995,1507,1764,-257,1891,16,51338,-343,14,2,M,L-,H,L-,E,M+
2021-01-24,337188,1918,49674,851,1507,-656,1907,11,50995,-1321,16,-5,L,H-,H,M-,E,H-
2021-01-25,338605,1930,47703,1417,851,566,1918,12,49674,-1971,11,1,M,H+,H,H-,E,L+
2021-01-26,340619,1945,45901,2014,1417,597,1930,15,47703,-1802,12,3,H,H+,H,M-,E,M+
2021-01-27,342385,1954,43054,1766,2014,-248,1945,9,45901,-2847,15,-6,M,L-,H,H-,H,H-
2021-01-28,343895,1966,40727,1510,1766,-256,1954,12,43054,-2327,9,3,M,L-,H,H-,E,M+
2021-01-29,345376,1975,39589,1481,1510,-29,1966,9,40727,-1138,12,-3,M,L-,H,M-,H,M-
2021-01-30,346566,1982,38464,1190,1481,-291,1975,7,39589,-1125,9,-2,M,M-,H,M-,H,M-
2021-01-31,347151,1991,37579,585,1190,-605,1982,9,38464,-885,7,2,L,H-,H,L-,H,M+
2021-02-01,348351,1995,36646,1200,585,615,1991,4,37579,-933,9,-5,M,H+,H,L-,M,H-
2021-02-02,349942,2003,35329,1591,1200,391,1995,8,36646,-1317,4,4,M,M+,H,M-,H,H+
2021-02-03,351215,2010,33858,1273,1591,-318,2003,7,35329,-1471,8,-1,M,M-,H,M-,H,L-
2021-02-04,352438,2021,32654,1223,1273,-50,2010,11,33858,-1204,7,4,M,L-,M,M-,E,H+
2021-02-05,353646,2026,31717,1208,1223,-15,2021,5,32654,-937,11,-6,M,L-,M,L-,M,H-
2021-02-06,354559,2037,31049,913,1208,-295,2026,11,31717,-668,5,6,M,M-,M,L-,E,H+
2021-02-07,355073,2047,30484,514,913,-399,2037,10,31049,-565,11,-1,L,M-,M,L-,H,L-
2021-02-08,356003,2055,30111,930,514,416,2047,8,30484,-373,10,-2,M,M+,M,L-,H,M-
2021-02-09,357307,2058,29272,1304,930,374,2055,3,30111,-839,8,-5,M,M+,M,L-,M,H-
2021-02-10,358557,2063,28429,1250,1304,-54,2058,5,29272,-843,3,2,M,L-,M,L-,M,M+
2021-02-11,359599,2068,26833,1042,1250,-208,2063,5,28429,-1596,5,0,M,L-,M,M-,M,L+
2021-02-12,360542,2073,26017,943,1042,-99,2068,5,26833,-816,5,0,M,L-,M,L-,M,L+
2021-02-13,361253,2081,25225,711,943,-232,2073,8,26017,-792,5,3,L,L-,M,L-,H,M+
2021-02-14,361716,2083,24839,463,711,-248,2081,2,25225,-386,8,-6,L,L-,M,L-,L,H-
2021-02-15,362297,2086,24009,581,463,118,2083,3,24839,-830,2,1,L,L+,M,L-,M,L+
2021-02-16,363194,2090,22903,897,581,316,2086,4,24009,-1106,3,1,M,M+,M,M-,M,L+
2021-02-17,364342,2095,22287,1148,897,251,2090,5,22903,-616,4,1,M,L+,M,L-,M,L+
2021-02-18,365200,2103,21636,858,1148,-290,2095,8,22287,-651,5,3,L,M-,M,L-,H,M+
2021-02-19,365983,2107,20946,783,858,-75,2103,4,21636,-690,8,-4,L,L-,M,L-,M,H-
2021-02-20,366688,2113,20459,705,783,-78,2107,6,20946,-487,4,2,L,L-,M,L-,H,M+
2021-02-21,367022,2116,20215,334,705,-371,2113,3,20459,-244,6,-3,L,M-,M,L-,M,M-
2021-02-22,367736,2123,19727,714,334,380,2116,7,20215,-488,3,4,L,M+,M,L-,H,H+
2021-02-23,368559,2132,18960,823,714,109,2123,9,19727,-767,7,2,L,L+,M,L-,H,M+
2021-02-24,369392,2135,18525,833,823,10,2132,3,18960,-435,9,-6,L,L+,M,L-,M,H-
2021-02-25,370047,2137,17959,655,833,-178,2135,2,18525,-566,3,-1,L,L-,M,L-,L,L-
2021-02-26,370734,2142,17438,687,655,32,2137,5,17959,-521,2,3,L,L+,M,L-,M,M+
2021-02-27,371199,2145,16989,465,687,-222,2142,3,17438,-449,5,-2,L,L-,M,L-,M,M-
2021-02-28,371462,2150,16735,263,465,-202,2145,5,16989,-254,3,2,L,L-,M,L-,M,M+
2021-03-01,371945,2155,16288,483,263,220,2150,5,16735,-447,5,0,L,L+,L,L-,M,L+
2021-03-02,372668,2160,15705,723,483,240,2155,5,16288,-583,5,0,L,L+,L,L-,M,L+
2021-03-03,373286,2164,15076,618,723,-105,2160,4,15705,-629,5,-1,L,L-,L,L-,M,L-
2021-03-04,373839,2167,14588,553,618,-65,2164,3,15076,-488,4,-1,L,L-,L,L-,M,L-
2021-03-05,374399,2173,14203,560,553,7,2167,6,14588,-385,3,3,L,L+,L,L-,H,M+
2021-03-06,374815,2176,13907,416,560,-144,2173,3,14203,-296,6,-3,L,L-,L,L-,M,M-
2021-03-07,375068,2179,13698,253,416,-163,2176,3,13907,-209,3,0,L,L-,L,L-,M,L+
2021-03-08,375626,2185,13670,558,253,305,2179,6,13698,-28,3,3,L,M+,L,L-,H,M+
2021-03-09,376280,2190,13427,654,558,96,2185,5,13670,-243,6,-1,L,L+,L,L-,M,L-
2021-03-10,376942,2193,12945,662,654,8,2190,3,13427,-482,5,-2,L,L+,L,L-,M,M-
2021-03-11,377463,2195,12612,521,662,-141,2193,2,12945,-333,3,-1,L,L-,L,L-,L,L-
2021-03-12,377957,2196,12326,494,521,-27,2195,1,12612,-286,2,-1,L,L-,L,L-,L,L-
2021-03-13,378355,2202,12015,398,494,-96,2196,6,12326,-311,1,5,L,L-,L,L-,H,H+
2021-03-14,378576,2204,11902,221,398,-177,2202,2,12015,-113,6,-4,L,L-,L,L-,L,H-
2021-03-15,379060,2206,11673,484,221,263,2204,2,11902,-229,2,0,L,L+,L,L-,L,L+
2021-03-16,379755,2208,11549,695,484,211,2206,2,11673,-124,2,0,L,L+,L,L-,L,L+
2021-03-17,380320,2212,11281,565,695,-130,2208,4,11549,-268,2,2,L,L-,L,L-,M,M+
2021-03-18,380767,2216,11074,447,565,-118,2212,4,11281,-207,4,0,L,L-,L,L-,M,L+
2021-03-19,381225,2220,10843,458,447,11,2216,4,11074,-231,4,0,L,L+,L,L-,M,L+
2021-03-20,381597,2222,10750,372,458,-86,2220,2,10843,-93,4,-2,L,L-,L,L-,L,M-
2021-03-21,381759,2224,10649,162,372,-210,2222,2,10750,-101,2,0,L,L-,L,L-,L,L+
2021-03-22,382145,2225,10553,386,162,224,2224,1,10649,-96,2,-1,L,L+,L,L-,L,L-
2021-03-23,382711,2226,10396,566,386,180,2225,1,10553,-157,1,0,L,L+,L,L-,L,L+
2021-03-24,383243,2228,10311,532,566,-34,2226,2,10396,-85,1,1,L,L-,L,L-,L,L+
2021-03-25,383693,2229,10209,450,532,-82,2228,1,10311,-102,2,-1,L,L-,L,L-,L,L-
2021-03-26,384146,2231,10105,453,450,3,2229,2,10209,-104,1,1,L,L+,L,L-,L,L+
2021-03-27,384533,2235,10072,387,453,-66,2231,4,10105,-33,2,2,L,L-,L,L-,M,M+
2021-03-28,384725,2237,10011,192,387,-195,2235,2,10072,-61,4,-2,L,L-,L,L-,L,M-
2021-03-29,385095,2237,9832,370,192,178,2237,0,10011,-179,2,-2,L,L+,L,L-,L,M-
2021-03-30,385616,2240,9701,521,370,151,2237,3,9832,-131,0,3,L,L+,L,L-,M,M+
2021-03-31,386111,2240,9536,495,521,-26,2240,0,9701,-165,3,-3,L,L-,L,L-,L,M-
2021-04-01,386536,2243,9446,425,495,-70,2240,3,9536,-90,0,3,L,L-,L,L-,M,M+
2021-04-02,386983,2243,9400,447,425,22,2243,0,9446,-46,3,-3,L,L+,L,L-,L,M-
2021-04-03,387326,2246,9344,343,447,-104,2243,3,9400,-56,0,3,L,L-,L,L-,M,M+
2021-04-04,387499,2247,9299,173,343,-170,2246,1,9344,-45,3,-2,L,L-,L,L-,L,M-
2021-04-05,387805,2249,9121,306,173,133,2247,2,9299,-178,1,1,L,L+,L,L-,L,L+
2021-04-06,388417,2250,9037,612,306,306,2249,1,9121,-84,2,-1,L,M+,L,L-,L,L-
2021-04-07,388902,2252,8956,485,612,-127,2250,2,9037,-81,1,1,L,L-,L,L-,L,L+
2021-04-08,389345,2254,8953,443,485,-42,2252,2,8956,-3,2,0,L,L-,L,L-,L,L+
2021-04-09,389749,2254,8901,404,443,-39,2254,0,8953,-52,2,-2,L,L-,L,L-,L,M-
2021-04-10,390093,2254,8878,344,404,-60,2254,0,8901,-23,0,0,L,L-,L,L-,L,L+
2021-04-11,390277,2255,8899,184,344,-160,2254,1,8878,21,0,1,L,L-,L,L+,L,L+
2021-04-12,390638,2256,8874,361,184,177,2255,1,8899,-25,1,0,L,L+,L,L-,L,L+
2021-04-13,391170,2259,8840,532,361,171,2256,3,8874,-34,1,2,L,L+,L,L-,M,M+
2021-04-14,391623,2260,8762,453,532,-79,2259,1,8840,-78,3,-2,L,L-,L,L-,L,M-
2021-04-15,392089,2263,8778,466,453,13,2260,3,8762,16,1,2,L,L+,L,L+,M,M+
2021-04-16,392500,2263,8739,411,466,-55,2263,0,8778,-39,3,-3,L,L-,L,L-,L,M-
2021-04-17,392744,2263,8600,244,411,-167,2263,0,8739,-139,0,0,L,L-,L,L-,L,L+
2021-04-18,392943,2265,8607,199,244,-45,2263,2,8600,7,0,2,L,L-,L,L+,L,M+
2021-04-19,393257,2268,8551,314,199,115,2265,3,8607,-56,2,1,L,L+,L,L-,M,L+
2021-04-20,393849,2271,8621,592,314,278,2268,3,8551,70,3,0,L,L+,L,L+,M,L+
2021-04-21,394313,2274,8591,464,592,-128,2271,3,8621,-30,3,0,L,L-,L,L-,M,L+
2021-04-22,394661,2279,8509,348,464,-116,2274,5,8591,-82,3,2,L,L-,L,L-,M,M+
2021-04-23,395127,2281,8529,466,348,118,2279,2,8509,20,5,-3,L,L+,L,L+,L,M-
2021-04-24,395407,2283,8465,280,466,-186,2281,2,8529,-64,2,0,L,L-,L,L-,L,L+
2021-04-25,395653,2288,8533,246,280,-34,2283,5,8465,68,2,3,L,L-,L,L+,M,M+
2021-04-26,395983,2291,8555,330,246,84,2288,3,8533,22,5,-2,L,L+,L,L+,M,M-
2021-04-27,396508,2292,8469,525,330,195,2291,1,8555,-86,3,-2,L,L+,L,L-,L,M-
2021-04-28,396967,2293,8442,459,525,-66,2292,1,8469,-27,1,0,L,L-,L,L-,L,L+
2021-04-29,397309,2294,8344,342,459,-117,2293,1,8442,-98,1,0,L,L-,L,L-,L,L+
2021-04-30,397718,2296,8347,409,342,67,2294,2,8344,3,1,1,L,L+,L,L+,L,L+
2021-05-01,397995,2297,8283,277,409,-132,2296,1,8347,-64,2,-1,L,L-,L,L-,L,L-
2021-05-02,398222,2297,8327,227,277,-50,2297,0,8283,44,1,-1,L,L-,L,L+,L,L-
2021-05-03,398483,2299,8228,261,227,34,2297,2,8327,-99,0,2,L,L+,L,L-,L,M+
2021-05-04,398963,2301,8177,480,261,219,2299,2,8228,-51,2,0,L,L+,L,L-,L,L+
2021-05-05,399360,2302,8126,397,480,-83,2301,1,8177,-51,2,-1,L,L-,L,L-,L,L-
2021-05-06,399744,2306,8043,384,397,-13,2302,4,8126,-83,1,3,L,L-,L,L-,M,M+
2021-05-07,400105,2306,7995,361,384,-23,2306,0,8043,-48,4,-4,L,L-,L,L-,L,H-
2021-05-08,400337,2307,7982,232,361,-129,2306,1,7995,-13,0,1,L,L-,L,L-,L,L+
2021-05-09,400545,2308,7991,208,232,-24,2307,1,7982,9,1,0,L,L-,L,L+,L,L+
2021-05-10,400764,2310,7896,219,208,11,2308,2,7991,-95,1,1,L,L+,L,L-,L,L+
2021-05-11,401227,2310,7768,463,219,244,2310,0,7896,-128,2,-2,L,L+,L,L-,L,M-
2021-05-12,401643,2311,7722,416,463,-47,2310,1,7768,-46,0,1,L,L-,L,L-,L,L+
2021-05-13,401987,2312,7720,344,416,-72,2311,1,7722,-2,1,0,L,L-,L,L-,L,L+
2021-05-14,402307,2314,7575,320,344,-24,2312,2,7720,-145,1,1,L,L-,L,L-,L,L+
2021-05-15,402554,2316,7540,247,320,-73,2314,2,7575,-35,2,0,L,L-,L,L-,L,L+
2021-05-16,402724,2318,7462,170,247,-77,2316,2,7540,-78,2,0,L,L-,L,L-,L,L+
2021-05-17,402979,2321,7387,255,170,85,2318,3,7462,-75,2,1,L,L+,L,L-,M,L+
2021-05-18,403406,2322,7290,427,255,172,2321,1,7387,-97,3,-2,L,L+,L,L-,L,M-
2021-05-19,403671,2327,7094,265,427,-162,2322,5,7290,-196,1,4,L,L-,L,L-,M,H+
2021-05-20,403969,2329,7050,298,265,33,2327,2,7094,-44,5,-3,L,L+,L,L-,L,M-
2021-05-21,404229,2332,6901,260,298,-38,2329,3,7050,-149,2,1,L,L-,L,L-,M,L+
2021-05-22,404453,2334,6846,224,260,-36,2332,2,6901,-55,3,-1,L,L-,L,L-,L,L-
2021-05-23,404601,2337,6768,148,224,-76,2334,3,6846,-78,2,1,L,L-,L,L-,M,L+
2021-05-24,404790,2339,6694,189,148,41,2337,2,6768,-74,3,-1,L,L+,L,L-,L,L-
2021-05-25,405067,2342,6490,277,189,88,2339,3,6694,-204,2,1,L,L+,L,L-,M,L+
2021-05-26,405374,2344,6401,307,277,30,2342,2,6490,-89,3,-1,L,L+,L,L-,L,L-
2021-05-27,405649,2345,6292,275,307,-32,2344,1,6401,-109,2,-1,L,L-,L,L-,L,L-
2021-05-28,405847,2347,6130,198,275,-77,2345,2,6292,-162,1,1,L,L-,L,L-,L,L+
2021-05-29,406017,2348,6068,170,198,-28,2347,1,6130,-62,2,-1,L,L-,L,L-,L,L-
2021-05-30,406157,2348,6004,140,170,-30,2348,0,6068,-64,1,-1,L,L-,L,L-,L,L-
2021-05-31,406270,2350,5898,113,140,-27,2348,2,6004,-106,0,2,L,L-,L,L-,L,M+
2021-06-01,406474,2353,5638,204,113,91,2350,3,5898,-260,2,1,L,L+,L,L-,M,L+
2021-06-02,406812,2353,5565,338,204,134,2353,0,5638,-73,3,-3,L,L+,L,L-,L,M-
2021-06-03,407099,2354,5509,287,338,-51,2353,1,5565,-56,0,1,L,L-,L,L-,L,L+
2021-06-04,407405,2355,5498,306,287,19,2354,1,5509,-11,1,0,L,L+,L,L-,L,L+
2021-06-05,407625,2357,5471,220,306,-86,2355,2,5498,-27,1,1,L,L-,L,L-,L,L+
2021-06-06,407799,2358,5476,174,220,-46,2357,1,5471,5,2,-1,L,L-,L,L+,L,L-
2021-06-07,408050,2360,5471,251,174,77,2358,2,5476,-5,1,1,L,L+,L,L-,L,L+
2021-06-08,408418,2361,5419,368,251,117,2360,1,5471,-52,2,-1,L,L+,L,L-,L,L-
2021-06-09,408735,2363,5471,317,368,-51,2361,2,5419,52,1,1,L,L-,L,L+,L,L+
2021-06-10,409000,2367,5437,265,317,-52,2363,4,5471,-34,2,2,L,L-,L,L-,M,M+
2021-06-11,409356,2369,5535,356,265,91,2367,2,5437,98,4,-2,L,L+,L,L+,L,M-
2021-06-12,409546,2370,5501,190,356,-166,2369,1,5535,-34,2,-1,L,L-,L,L-,L,L-
2021-06-13,409715,2370,5522,169,190,-21,2370,0,5501,21,1,-1,L,L-,L,L+,L,L-
2021-06-14,409954,2370,5574,239,169,70,2370,0,5522,52,0,0,L,L+,L,L+,L,L+
2021-06-15,410366,2374,5708,412,239,173,2370,4,5574,134,0,4,L,L+,L,L+,M,H+
2021-06-16,410737,2374,5774,371,412,-41,2374,0,5708,66,4,-4,L,L-,L,L+,L,H-
2021-06-17,411060,2377,5820,323,371,-48,2374,3,5774,46,0,3,L,L-,L,L+,M,M+
2021-06-18,411348,2381,5909,288,323,-35,2377,4,5820,89,3,1,L,L-,L,L+,M,L+
2021-06-19,411600,2384,5991,252,288,-36,2381,3,5909,82,4,-1,L,L-,L,L+,M,L-
2021-06-20,411761,2386,6012,161,252,-91,2384,2,5991,21,3,-1,L,L-,L,L+,L,L-
2021-06-21,412014,2390,6149,253,161,92,2386,4,6012,137,2,2,L,L+,L,L+,M,M+
2021-06-22,412537,2397,6468,523,253,270,2390,7,6149,319,4,3,L,L+,L,L+,H,M+
2021-06-23,412995,2399,6586,458,523,-65,2397,2,6468,118,7,-5,L,L-,L,L+,L,H-
2021-06-24,413306,2403,6609,311,458,-147,2399,4,6586,23,2,2,L,L-,L,L+,M,M+
2021-06-25,413657,2405,6658,351,311,40,2403,2,6609,49,4,-2,L,L+,L,L+,L,M-
2021-06-26,413937,2406,6717,280,351,-71,2405,1,6658,59,2,-1,L,L-,L,L+,L,L-
2021-06-27,414189,2408,6794,252,280,-28,2406,2,6717,77,1,1,L,L-,L,L+,L,L+
2021-06-28,414562,2410,6917,373,252,121,2408,2,6794,123,2,0,L,L+,L,L+,L,L+
2021-06-29,415127,2411,7117,565,373,192,2410,1,6917,200,2,-1,L,L+,L,L+,L,L-
2021-06-30,415669,2414,7341,542,565,-23,2411,3,7117,224,1,2,L,L-,L,L+,M,M+
2021-07-01,416105,2415,7516,436,542,-106,2414,1,7341,175,3,-2,L,L-,L,L+,L,M-
2021-07-02,416583,2416,7643,478,436,42,2415,1,7516,127,1,0,L,L+,L,L+,L,L+
2021-07-03,416931,2420,7799,348,478,-130,2416,4,7643,156,1,3,L,L-,L,L+,M,M+
2021-07-04,417092,2425,7788,161,348,-187,2420,5,7799,-11,4,1,L,L-,L,L-,M,L+
2021-07-05,417256,2427,7715,164,161,3,2425,2,7788,-73,5,-3,L,L+,L,L-,L,M-
2021-07-06,417649,2432,7696,393,164,229,2427,5,7715,-19,2,3,L,L+,L,L-,M,M+
2021-07-07,418320,2433,7997,671,393,278,2432,1,7696,301,5,-4,L,L+,L,L+,L,H-
2021-07-08,418969,2437,8321,649,671,-22,2433,4,7997,324,1,3,L,L-,L,L+,M,M+
2021-07-09,419427,2441,8492,458,649,-191,2437,4,8321,171,4,0,L,L-,L,L+,M,L+
2021-07-10,419910,2444,8720,483,458,25,2441,3,8492,228,4,-1,L,L+,L,L+,M,L-
2021-07-11,420171,2446,8820,261,483,-222,2444,2,8720,100,3,-1,L,L-,L,L+,L,L-
2021-07-12,420651,2450,9044,480,261,219,2446,4,8820,224,2,2,L,L+,L,L+,M,M+
2021-07-13,421251,2453,9125,600,480,120,2450,3,9044,81,4,-1,L,L+,L,L+,M,L-
2021-07-14,421943,2454,9362,692,600,92,2453,1,9125,237,3,-2,L,L+,L,L+,L,M-
2021-07-15,422624,2457,9734,681,692,-11,2454,3,9362,372,1,2,L,L-,L,L+,M,M+
2021-07-16,423248,2459,10011,624,681,-57,2457,2,9734,277,3,-1,L,L-,L,L+,L,L-
2021-07-17,423762,2461,10246,514,624,-110,2459,2,10011,235,2,0,L,L-,L,L+,L,L+
2021-07-18,424165,2461,10401,403,514,-111,2461,0,10246,155,2,-2,L,L-,L,L+,L,M-
2021-07-19,424731,2463,10595,566,403,163,2461,2,10401,194,0,2,L,L+,L,L+,L,M+
2021-07-20,425597,2464,10898,866,566,300,2463,1,10595,303,2,-1,L,M+,L,L+,L,L-
2021-07-21,426413,2469,11173,816,866,-50,2464,5,10898,275,1,4,L,L-,L,L+,M,H+
2021-07-22,427180,2473,11508,767,816,-49,2469,4,11173,335,5,-1,L,L-,L,L+,M,L-
2021-07-23,427848,2478,11698,668,767,-99,2473,5,11508,190,4,1,L,L-,L,L+,M,L+
2021-07-24,428352,2482,11851,504,668,-164,2478,4,11698,153,5,-1,L,L-,L,L+,M,L-
2021-07-25,428683,2485,12021,331,504,-173,2482,3,11851,170,4,-1,L,L-,L,L+,M,L-
2021-07-26,429296,2487,12468,613,331,282,2485,2,12021,447,3,-1,L,M+,L,L+,L,L-
2021-07-27,430135,2491,12913,839,613,226,2487,4,12468,445,2,2,L,L+,L,L+,M,M+
2021-07-28,431244,2493,13356,1109,839,270,2491,2,12913,443,4,-2,M,L+,L,L+,L,M-
2021-07-29,432459,2499,13922,1215,1109,106,2493,6,13356,566,2,4,M,L+,L,L+,H,H+
2021-07-30,433414,2503,14419,955,1215,-260,2499,4,13922,497,6,-2,M,L-,L,L+,M,M-
2021-07-31,434201,2514,14712,787,955,-168,2503,11,14419,293,4,7,L,L-,L,L+,E,H+
2021-08-01,434699,2522,14943,498,787,-289,2514,8,14712,231,11,-3,L,M-,L,L+,H,M-
2021-08-02,435433,2531,15191,734,498,236,2522,9,14943,248,8,1,L,L+,L,L+,H,L+
2021-08-03,436482,2536,15640,1049,734,315,2531,5,15191,449,9,-4,M,M+,L,L+,M,H-
2021-08-04,437578,2539,16046,1096,1049,47,2536,3,15640,406,5,-2,M,L+,L,L+,M,M-
2021-08-05,438473,2544,16257,895,1096,-201,2539,5,16046,211,3,2,M,L-,L,L+,M,M+
2021-08-06,439420,2550,16579,947,895,52,2544,6,16257,322,5,1,M,L+,L,L+,H,L+
2021-08-07,440080,2554,16722,660,947,-287,2550,4,16579,143,6,-2,L,M-,M,L+,M,M-
2021-08-08,440482,2559,16724,402,660,-258,2554,5,16722,2,4,1,L,L-,M,L+,M,L+
2021-08-09,441118,2567,16797,636,402,234,2559,8,16724,73,5,3,L,L+,M,L+,H,M+
2021-08-10,442228,2570,17044,1110,636,474,2567,3,16797,247,8,-5,M,M+,M,L+,M,H-
2021-08-11,443471,2575,17473,1243,1110,133,2570,5,17044,429,3,2,M,L+,M,L+,M,M+
2021-08-12,444356,2580,17594,885,1243,-358,2575,5,17473,121,5,0,L,M-,M,L+,M,L+
2021-08-13,445493,2588,18055,1137,885,252,2580,8,17594,461,5,3,M,L+,M,L+,H,M+
2021-08-14,446374,2594,18431,881,1137,-256,2588,6,18055,376,8,-2,L,L-,M,L+,H,M-
2021-08-15,446792,2601,18516,418,881,-463,2594,7,18431,85,6,1,L,M-,M,L+,H,L+
2021-08-16,447763,2610,18873,971,418,553,2601,9,18516,357,7,2,M,M+,M,L+,H,M+
2021-08-17,449247,2615,19521,1484,971,513,2610,5,18873,648,9,-4,M,M+,M,L+,M,H-
2021-08-18,450529,2622,19691,1282,1484,-202,2615,7,19521,170,5,2,M,L-,M,L+,H,M+
2021-08-19,451651,2631,19597,1122,1282,-160,2622,9,19691,-94,7,2,M,L-,M,L-,H,M+
2021-08-20,452867,2640,19858,1216,1122,94,2631,9,19597,261,9,0,M,L+,M,L+,H,L+
2021-08-21,453727,2645,19933,860,1216,-356,2640,5,19858,75,9,-4,L,M-,M,L+,M,H-
2021-08-22,454373,2653,20082,646,860,-214,2645,8,19933,149,5,3,L,L-,M,L+,H,M+
2021-08-23,455512,2661,20487,1139,646,493,2653,8,20082,405,8,0,M,M+,M,L+,H,L+
2021-08-24,457093,2667,21026,1581,1139,442,2661,6,20487,539,8,-2,M,M+,M,L+,H,M-
2021-08-25,458585,2677,21416,1492,1581,-89,2667,10,21026,390,6,4,M,L-,M,L+,H,H+
2021-08-26,459883,2684,21818,1298,1492,-194,2677,7,21416,402,10,-3,M,L-,M,L+,H,M-
2021-08-27,461481,2690,22472,1598,1298,300,2684,6,21818,654,7,-1,M,M+,M,L+,H,L-
2021-08-28,462602,2700,22926,1121,1598,-477,2690,10,22472,454,6,4,M,M-,M,L+,H,H+
2021-08-29,463199,2705,23119,597,1121,-524,2700,5,22926,193,10,-5,L,M-,M,L+,M,H-
2021-08-30,464420,2718,23694,1221,597,624,2705,13,23119,575,5,8,M,H+,M,L+,E,H+
2021-08-31,466097,2723,24268,1677,1221,456,2718,5,23694,574,13,-8,M,M+,M,L+,M,H-
2021-09-01,467786,2735,24711,1689,1677,12,2723,12,24268,443,5,7,M,L+,M,L+,E,H+
2021-09-02,469413,2738,25454,1627,1689,-62,2735,3,24711,743,12,-9,M,L-,M,L+,M,H-
2021-09-03,471283,2747,26187,1870,1627,243,2738,9,25454,733,3,6,H,L+,M,L+,H,H+
2021-09-04,472468,2758,26482,1185,1870,-685,2747,11,26187,295,9,2,M,H-,M,L+,E,M+
2021-09-05,473384,2769,26975,916,1185,-269,2758,11,26482,493,11,0,M,L-,M,L+,E,L+
2021-09-06,474091,2776,26719,707,916,-209,2769,7,26975,-256,11,-4,L,L-,M,L-,H,H-
2021-09-07,475624,2787,26779,1533,707,826,2776,11,26719,60,7,4,M,H+,M,L+,E,H+
2021-09-08,477788,2797,27659,2164,1533,631,2787,10,26779,880,11,-1,H,H+,M,L+,H,L-
2021-09-09,479977,2803,28725,2189,2164,25,2797,6,27659,1066,10,-4,H,L+,M,M+,H,H-
2021-09-10,481820,2816,29347,1843,2189,-346,2803,13,28725,622,6,7,H,M-,M,L+,E,H+
2021-09-11,483180,2821,29848,1360,1843,-483,2816,5,29347,501,13,-8,M,M-,M,L+,M,H-
2021-09-12,484200,2829,30224,1020,1360,-340,2821,8,29848,376,5,3,M,M-,M,L+,H,M+
2021-09-13,485467,2838,30356,1267,1020,247,2829,9,30224,132,8,1,M,L+,M,L+,H,L+
2021-09-14,487347,2846,30653,1880,1267,613,2838,8,30356,297,9,-1,H,H+,M,L+,H,L-
2021-09-15,489231,2857,31052,1884,1880,4,2846,11,30653,399,8,3,H,L+,M,L+,E,M+
2021-09-16,490983,2869,31508,1752,1884,-132,2857,12,31052,456,11,1,M,L-,M,L+,E,L+
2021-09-17,492352,2877,31281,1369,1752,-383,2869,8,31508,-227,12,-4,M,M-,M,L-,H,H-
2021-09-18,493476,2887,31287,1124,1369,-245,2877,10,31281,6,8,2,M,L-,M,L+,H,M+
2021-09-19,494372,2900,31578,896,1124,-228,2887,13,31287,291,10,3,M,L-,M,L+,E,M+
2021-09-20,495704,2913,31686,1332,896,436,2900,13,31578,108,13,0,M,M+,M,L+,E,L+
2021-09-21,497420,2922,31731,1716,1332,384,2913,9,31686,45,13,-4,M,M+,M,L+,H,H-
2021-09-22,499028,2944,31637,1608,1716,-108,2922,22,31731,-94,9,13,M,L-,M,L-,E,H+
2021-09-23,500699,2953,31683,1671,1608,63,2944,9,31637,46,22,-13,M,L+,M,L+,H,H-
2021-09-24,502059,2962,31179,1360,1671,-311,2953,9,31683,-504,9,0,M,M-,M,L-,H,L+
2021-09-25,503086,2969,31023,1027,1360,-333,2962,7,31179,-156,9,-2,M,M-,M,L-,H,M-
2021-09-26,503880,2977,30900,794,1027,-233,2969,8,31023,-123,7,1,L,L-,M,L-,H,L+
2021-09-27,505003,2989,31309,1123,794,329,2977,12,30900,409,8,4,M,M+,M,L+,E,H+
2021-09-28,506798,3001,31570,1795,1123,672,2989,12,31309,261,12,0,H,H+,M,L+,E,L+
2021-09-29,508494,3010,31112,1696,1795,-99,3001,9,31570,-458,12,-3,M,L-,M,L-,H,M-
2021-09-30,510215,3018,30652,1721,1696,25,3010,8,31112,-460,9,-1,M,L+,M,L-,H,L-
2021-10-01,511584,3027,30183,1369,1721,-352,3018,9,30652,-469,8,1,M,M-,M,L-,H,L+
2021-10-02,512662,3039,29900,1078,1369,-291,3027,12,30183,-283,9,3,M,M-,M,L-,E,M+
2021-10-03,513505,3049,29727,843,1078,-235,3039,10,29900,-173,12,-2,L,L-,M,L-,H,M-
2021-10-04,514760,3056,29722,1255,843,412,3049,7,29727,-5,10,-3,M,M+,M,L-,H,M-
2021-10-05,516732,3066,29820,1972,1255,717,3056,10,29722,98,7,3,H,H+,M,L+,H,M+
2021-10-06,518482,3079,29688,1750,1972,-222,3066,13,29820,-132,10,3,M,L-,M,L-,E,M+
2021-10-07,520137,3098,29582,1655,1750,-95,3079,19,29688,-106,13,6,M,L-,M,L-,E,H+
2021-10-08,521382,3110,29459,1245,1655,-410,3098,12,29582,-123,19,-7,M,M-,M,L-,E,H-
2021-10-09,522240,3118,29194,858,1245,-387,3110,8,29459,-265,12,-4,L,M-,M,L-,H,H-
2021-10-10,523463,3124,29523,1223,858,365,3118,6,29194,329,8,-2,M,M+,M,L+,H,M-
2021-10-11,524558,3135,29286,1095,1223,-128,3124,11,29523,-237,6,5,M,L-,M,L-,E,H+
2021-10-12,526383,3149,29398,1825,1095,730,3135,14,29286,112,11,3,H,H+,M,L+,E,M+
2021-10-13,527623,3163,29027,1240,1825,-585,3149,14,29398,-371,14,0,M,H-,M,L-,E,L+
2021-10-14,529127,3176,28860,1504,1240,264,3163,13,29027,-167,14,-1,M,L+,M,L-,E,L-
2021-10-15,530449,3187,28820,1322,1504,-182,3176,11,28860,-40,13,-2,M,L-,M,L-,E,M-
2021-10-16,531539,3201,28878,1090,1322,-232,3187,14,28820,58,11,3,M,L-,M,L+,E,M+
2021-10-17,532170,3205,28716,631,1090,-459,3201,4,28878,-162,14,-10,L,M-,M,L-,M,H-
2021-10-18,533520,3213,28952,1350,631,719,3205,8,28716,236,4,4,M,H+,M,L+,H,H+
2021-10-19,534898,3221,28537,1378,1350,28,3213,8,28952,-415,8,0,M,L+,M,L-,H,L+
2021-10-20,537242,3235,29181,2344,1378,966,3221,14,28537,644,8,6,H,H+,M,L+,E,H+
2021-10-21,538882,3242,29111,1640,2344,-704,3235,7,29181,-70,14,-7,M,H-,M,L-,H,H-
2021-10-22,540555,3248,29420,1673,1640,33,3242,6,29111,309,7,-1,M,L+,M,L+,H,L-
2021-10-23,541803,3254,29593,1248,1673,-425,3248,6,29420,173,6,0,M,M-,M,L+,H,L+
2021-10-24,542530,3275,29460,727,1248,-521,3254,21,29593,-133,6,15,L,M-,M,L-,E,H+
2021-10-25,544156,3285,29827,1626,727,899,3275,10,29460,367,21,-11,M,H+,M,L+,H,H-
2021-10-26,546193,3304,29887,2037,1626,411,3285,19,29827,60,10,9,H,M+,M,L+,E,H+
2021-10-27,548025,3316,29971,1832,2037,-205,3304,12,29887,84,19,-7,H,L-,M,L+,E,H-
2021-10-28,549835,3335,30116,1810,1832,-22,3316,19,29971,145,12,7,H,L-,M,L+,E,H+
2021-10-29,551448,3347,30491,1613,1810,-197,3335,12,30116,375,19,-7,M,L-,M,L+,E,H-
2021-10-30,552084,3359,30263,636,1613,-977,3347,12,30491,-228,12,0,L,H-,M,L-,E,L+
2021-10-31,553050,3371,30002,966,636,330,3359,12,30263,-261,12,0,M,M+,M,L-,E,L+
2021-11-01,554321,3388,30167,1271,966,305,3371,17,30002,165,12,5,M,M+,M,L+,E,H+
2021-11-02,556436,3398,30462,2115,1271,844,3388,10,30167,295,17,-7,H,H+,M,L+,H,H-
2021-11-03,558693,3410,31477,2257,2115,142,3398,12,30462,1015,10,2,H,L+,M,M+,E,M+
2021-11-04,560571,3416,31856,1878,2257,-379,3410,6,31477,379,12,-6,H,M-,M,L+,H,H-
2021-11-05,562593,3431,32553,2022,1878,144,3416,15,31856,697,6,9,H,L+,M,L+,E,H+
2021-11-06,563399,3446,32261,806,2022,-1216,3431,15,32553,-292,15,0,L,H-,M,L-,E,L+
2021-11-07,564605,3449,32840,1206,806,400,3446,3,32261,579,15,-12,M,M+,M,L+,M,H-
2021-11-08,566149,3460,33040,1544,1206,338,3449,11,32840,200,3,8,M,M+,M,L+,E,H+
2021-11-09,567693,3476,33200,1544,1544,0,3460,16,33040,160,11,5,M,L+,H,L+,E,H+
2021-11-10,569770,3489,32933,2077,1544,533,3476,13,33200,-267,16,-3,H,M+,M,L-,E,M-
2021-11-11,571544,3504,33065,1774,2077,-303,3489,15,32933,132,13,2,H,M-,M,L+,E,M+
2021-11-12,573582,3512,33432,2038,1774,264,3504,8,33065,367,15,-7,H,L+,H,L+,H,H-
2021-11-13,574891,3516,33503,1309,2038,-729,3512,4,33432,71,8,-4,M,H-,H,L+,M,H-
2021-11-14,576041,3530,33922,1150,1309,-159,3516,14,33503,419,4,10,M,L-,H,L+,E,H+
2021-11-15,577301,3540,33557,1260,1150,110,3530,10,33922,-365,14,-4,M,L+,H,L-,H,H-
2021-11-16,579400,3552,33620,2099,1260,839,3540,12,33557,63,10,2,H,H+,H,L+,E,M+
2021-11-17,581193,3557,33592,1793,2099,-306,3552,5,33620,-28,12,-7,H,M-,H,L-,M,H-
2021-11-18,582960,3566,33556,1767,1793,-26,3557,9,33592,-36,5,4,M,L-,H,L-,H,H+
2021-11-19,584535,3578,33521,1575,1767,-192,3566,12,33556,-35,9,3,M,L-,H,L-,E,M+
2021-11-20,585758,3587,34102,1223,1575,-352,3578,9,33521,581,12,-3,M,M-,H,L+,H,M-
2021-11-21,586796,3600,34167,1038,1223,-185,3587,13,34102,65,9,4,M,L-,H,L+,E,H+
2021-11-22,587957,3606,34060,1161,1038,123,3600,6,34167,-107,13,-7,M,L+,H,L-,H,H-
2021-11-23,589716,3618,33707,1759,1161,598,3606,12,34060,-353,6,6,M,H+,H,L-,E,H+
2021-11-24,591270,3629,33005,1554,1759,-205,3618,11,33707,-702,12,-1,M,L-,M,L-,E,L-
2021-11-25,592155,3638,32014,885,1554,-669,3629,9,33005,-991,11,-2,L,H-,M,M-,H,M-
2021-11-26,592713,3642,30564,558,885,-327,3638,4,32014,-1450,9,-5,L,M-,M,M-,M,H-
2021-11-27,593727,3647,30774,1014,558,456,3642,5,30564,210,4,1,M,M+,M,L+,M,L+
2021-11-28,594630,3658,30472,903,1014,-111,3647,11,30774,-302,5,6,M,L-,M,L-,E,H+
2021-11-29,595816,3673,30111,1186,903,283,3658,15,30472,-361,11,4,M,M+,M,L-,E,H+
2021-11-30,598113,3683,30872,2297,1186,1111,3673,10,30111,761,15,-5,H,H+,M,L+,H,H-
2021-12-01,600088,3693,30772,1975,2297,-322,3683,10,30872,-100,10,0,H,M-,M,L-,H,L+
2021-12-02,601970,3707,30884,1882,1975,-93,3693,14,30772,112,10,4,H,L-,M,L+,E,H+
2021-12-03,603398,3713,30276,1428,1882,-454,3707,6,30884,-608,14,-8,M,M-,M,L-,H,H-
2021-12-04,604564,3719,30136,1166,1428,-262,3713,6,30276,-140,6,0,M,L-,M,L-,H,L+
2021-12-05,605472,3724,29901,908,1166,-258,3719,5,30136,-235,6,-1,M,L-,M,L-,M,L-
2021-12-06,606592,3736,29761,1120,908,212,3724,12,29901,-140,5,7,M,L+,M,L-,E,H+
2021-12-07,608014,3745,29090,1422,1120,302,3736,9,29761,-671,12,-3,M,M+,M,L-,H,M-
2021-12-08,609392,3756,28675,1378,1422,-44,3745,11,29090,-415,9,2,M,L-,M,L-,E,M+
2021-12-09,610721,3766,28232,1329,1378,-49,3756,10,28675,-443,11,-1,M,L-,M,L-,H,L-
2021-12-10,611804,3770,27746,1083,1329,-246,3766,4,28232,-486,10,-6,M,L-,M,L-,M,H-
2021-12-11,612678,3776,27401,874,1083,-209,3770,6,27746,-345,4,2,L,L-,M,L-,H,M+
2021-12-12,613424,3788,27105,746,874,-128,3776,12,27401,-296,6,6,L,L-,M,L-,E,H+
2021-12-13,614328,3800,26847,904,746,158,3788,12,27105,-258,12,0,M,L+,M,L-,E,L+
2021-12-14,615609,3811,26369,1281,904,377,3800,11,26847,-478,12,-1,M,M+,M,L-,E,L-
2021-12-15,616726,3817,25933,1117,1281,-164,3811,6,26369,-436,11,-5,M,L-,M,L-,H,H-
2021-12-16,617748,3824,26066,1022,1117,-95,3817,7,25933,133,6,1,M,L-,M,L+,H,L+
2021-12-17,618657,3828,26421,909,1022,-113,3824,4,26066,355,7,-3,M,L-,M,L+,M,M-
2021-12-18,619523,3841,26265,866,909,-43,3828,13,26421,-156,4,9,L,L-,M,L-,E,H+
2021-12-19,620281,3848,26123,758,866,-108,3841,7,26265,-142,13,-6,L,L-,M,L-,H,H-
2021-12-20,621086,3857,25741,805,758,47,3848,9,26123,-382,7,2,L,L+,M,L-,H,M+
2021-12-21,622470,3867,24832,1384,805,579,3857,10,25741,-909,9,1,M,H+,M,L-,H,L+
2021-12-22,623743,3873,24135,1273,1384,-111,3867,6,24832,-697,10,-4,M,L-,M,L-,H,H-
2021-12-23,625223,3880,23735,1480,1273,207,3873,7,24135,-400,6,1,M,L+,M,L-,H,L+
2021-12-24,626531,3881,23629,1308,1480,-172,3880,1,23735,-106,7,-6,M,L-,M,L-,L,H-
2021-12-25,627746,3889,23674,1215,1308,-93,3881,8,23629,45,1,7,M,L-,M,L+,H,H+
2021-12-26,628368,3896,23391,622,1215,-593,3889,7,23674,-283,8,-1,L,H-,M,L-,H,L-
2021-12-27,630146,3901,24054,1778,622,1156,3896,5,23391,663,7,-2,H,H+,M,L+,M,M-
2021-12-28,633388,3907,25873,3242,1778,1464,3901,6,24054,1819,5,1,H,H+,M,M+,H,L+
2021-12-29,636943,3915,28055,3555,3242,313,3907,8,25873,2182,6,2,E,M+,M,H+,H,M+
2021-12-30,641597,3920,31382,4654,3555,1099,3915,5,28055,3327,8,-3,E,H+,M,H+,M,M-
2021-12-31,645388,3927,34096,3791,4654,-863,3920,7,31382,2714,5,2,E,H-,H,H+,H,M+
2022-01-01,648620,3934,36455,3232,3791,-559,3927,7,34096,2359,7,0,H,H-,H,H+,H,L+
2022-01-02,651689,3940,38775,3069,3232,-163,3934,6,36455,2320,7,-1,H,L-,H,H+,H,L-
2022-01-03,656267,3949,42448,4578,3069,1509,3940,9,38775,3673,6,3,E,H+,H,H+,H,M+
2022-01-04,663365,3956,48265,7098,4578,2520,3949,7,42448,5817,9,-2,E,H+,H,H+,H,M-
2022-01-05,672238,3965,56022,8873,7098,1775,3956,9,48265,7757,7,2,E,H+,H,H+,H,M+
2022-01-06,681539,3974,64299,9301,8873,428,3965,9,56022,8277,9,0,E,M+,H,H+,H,L+
2022-01-07,690850,3983,72694,9311,9301,10,3974,9,64299,8395,9,0,E,L+,E,H+,H,L+
2022-01-08,699283,3991,80256,8433,9311,-878,3983,8,72694,7562,9,-1,E,H-,E,H+,H,L-
2022-01-09,705550,4001,85759,6267,8433,-2166,3991,10,80256,5503,8,2,E,H-,E,H+,H,M+
2022-01-10,715606,4008,95014,10056,6267,3789,4001,7,85759,9255,10,-3,E,H+,E,H+,H,M-
2022-01-11,725952,4018,103980,10346,10056,290,4008,10,95014,8966,7,3,E,M+,E,H+,H,M+
2022-01-12,738995,4025,115747,13043,10346,2697,4018,7,103980,11767,10,-3,E,H+,E,H+,H,M-
2022-01-13,750193,4036,125458,11198,13043,-1845,4025,11,115747,9711,7,4,E,H-,E,H+,E,H+
2022-01-14,763717,4051,137672,13524,11198,2326,4036,15,125458,12214,11,4,E,H+,E,H+,E,H+
2022-01-15,773791,4061,146525,10074,13524,-3450,4051,10,137672,8853,15,-5,E,H-,E,H+,H,H-
2022-01-16,780125,4073,152234,6334,10074,-3740,4061,12,146525,5709,10,2,E,H-,E,H+,E,M+
2022-01-17,790035,4089,160354,9910,6334,3576,4073,16,152234,8120,12,4,E,H+,E,H+,E,H+
2022-01-18,802607,4100,169687,12572,9910,2662,4089,11,160354,9333,16,-5,E,H+,E,H+,E,H-
2022-01-19,814214,4112,177733,11607,12572,-965,4100,12,169687,8046,11,1,E,H-,E,H+,E,L+
2022-01-20,825816,4123,184693,11602,11607,-5,4112,11,177733,6960,12,-1,E,L-,E,H+,E,L-
2022-01-21,836411,4141,191489,10595,11602,-1007,4123,18,184693,6796,11,7,E,H-,E,H+,E,H+
2022-01-22,843249,4155,195087,6838,10595,-3757,4141,14,191489,3598,18,-4,E,H-,E,H+,E,H-
2022-01-23,847796,4169,196566,4547,6838,-2291,4155,14,195087,1479,14,0,E,H-,E,M+,E,L+
2022-01-24,854405,4182,198597,6609,4547,2062,4169,13,196566,2031,14,-1,E,H+,E,H+,E,L-
2022-01-25,861870,4191,198975,7465,6609,856,4182,9,198597,378,13,-4,E,H+,E,L+,H,H-
2022-01-26,868854,4197,197088,6984,7465,-481,4191,6,198975,-1887,9,-3,E,M-,E,M-,H,M-
2022-01-27,875014,4209,193945,6160,6984,-824,4197,12,197088,-3143,6,6,E,H-,E,H-,E,H+
2022-01-28,879810,4214,189432,4796,6160,-1364,4209,5,193945,-4513,12,-7,E,H-,E,H-,M,H-
2022-01-29,883009,4223,184202,3199,4796,-1597,4214,9,189432,-5230,5,4,H,H-,E,H-,H,H+
2022-01-30,885321,4234,180249,2312,3199,-887,4223,11,184202,-3953,9,2,H,H-,E,H-,E,M+
2022-01-31,888154,4245,173035,2833,2312,521,4234,11,180249,-7214,11,0,H,M+,E,H-,E,L+
2022-02-01,891767,4252,166314,3613,2833,780,4245,7,173035,-6721,11,-4,E,H+,E,H-,H,H-
2022-02-02,895227,4267,156737,3460,3613,-153,4252,15,166314,-9577,7,8,H,L-,E,H-,E,H+
2022-02-03,898029,4281,148349,2802,3460,-658,4267,14,156737,-8388,15,-1,H,H-,E,H-,E,L-
2022-02-04,900533,4289,137334,2504,2802,-298,4281,8,148349,-11015,14,-6,H,M-,E,H-,H,H-
2022-02-05,902252,4300,128987,1719,2504,-785,4289,11,137334,-8347,8,3,M,H-,E,H-,E,M+
2022-02-06,903569,4310,123973,1317,1719,-402,4300,10,128987,-5014,11,-1,M,M-,E,H-,H,L-
2022-02-07,904913,4327,115404,1344,1317,27,4310,17,123973,-8569,10,7,M,L+,E,H-,E,H+
2022-02-08,906932,4334,104859,2019,1344,675,4327,7,115404,-10545,17,-10,H,H+,E,H-,H,H-
2022-02-09,908893,4342,95220,1961,2019,-58,4334,8,104859,-9639,7,1,H,L-,E,H-,H,L+
2022-02-10,910685,4349,85419,1792,1961,-169,4342,7,95220,-9801,8,-1,H,L-,E,H-,H,L-
2022-02-11,912037,4359,76185,1352,1792,-440,4349,10,85419,-9234,7,3,M,M-,E,H-,H,M+
2022-02-12,913156,4370,70467,1119,1352,-233,4359,11,76185,-5718,10,1,M,L-,E,H-,E,L+
2022-02-13,913810,4376,66576,654,1119,-465,4370,6,70467,-3891,11,-5,L,M-,E,H-,H,H-
2022-02-14,914577,4380,60739,767,654,113,4376,4,66576,-5837,6,-2,L,L+,H,H-,M,M-
2022-02-15,915987,4383,54696,1410,767,643,4380,3,60739,-6043,4,-1,M,H+,H,H-,M,L-
2022-02-16,917014,4388,48752,1027,1410,-383,4383,5,54696,-5944,3,2,M,M-,H,H-,M,M+
2022-02-17,918046,4394,43630,1032,1027,5,4388,6,48752,-5122,5,1,M,L+,H,H-,H,L+
2022-02-18,918890,4397,39684,844,1032,-188,4394,3,43630,-3946,6,-3,L,L-,H,H-,M,M-
2022-02-19,919454,4402,37051,564,844,-280,4397,5,39684,-2633,3,2,L,M-,H,H-,M,M+
2022-02-20,919830,4406,35113,376,564,-188,4402,4,37051,-1938,5,-1,L,L-,H,M-,M,L-
2022-02-21,920143,4408,32607,313,376,-63,4406,2,35113,-2506,4,-2,L,L-,M,H-,L,M-
2022-02-22,920803,4408,29663,660,313,347,4408,0,32607,-2944,2,-2,L,M+,M,H-,L,M-
2022-02-23,921467,4408,26879,664,660,4,4408,0,29663,-2784,0,0,L,L+,M,H-,L,L+
2022-02-24,921956,4408,24575,489,664,-175,4408,0,26879,-2304,0,0,L,L-,M,H-,L,L+
